.	。
,	、
:	：
!	！
?	？

a	あ
o	お
e	え
u	う
i	い
A ぁ
O ぉ
E ぇ
U ぅ
I ぃ
wA ゎ
kA ヵ
kE ヶ

p	ぱ
pa	ぱ
pi	ぴ
pu	ぶ
pe	ぺ
po	ぽ
y	や
ya	や
yu	ゆ
yo	よ
f	ふ
fa	ふぁ
fi	ふぃ
fu	ふ
fe	ふぇ
fo	ふぉ
g	が
ga	が
gi	ぎ
gu	ぐ
ge	げ
go	ご
c	つ
ca	つぁ
ci	つぃ
cu	つ
ce	つぇ
co	つぉ
r	ら
ra	ら
ri	り
ru	る
re	れ
ro	ろ
d	だ
da	だ
di	でいずに
du	づ
de	で
do	ど
h	は
ha	は
hi	ひ
he	へ
ho	ほ
t	た
ta	た
te	て
to	と
n	な
na	な
ni	に
nu	ぬ
ne	ね
no	の
s	さ
sa	さ
su	す
se	せ
so	そ
q	ち
qa	ちゃ
qi	ち
qu	ちゅ
qe	ちぇ
qo	ちょ
j	じ
ja	じゃ
ji	じ
ju	じゅ
je	じぇ
jo	じぉ
k	か
ka	か
ki	き
ku	く
ke	け
ko	こ
x	し
xa	しゃ
xi	し
xu	しゅ
xe	しぇ
xo	しょ
b	ば
ba	ば
bi	び
bu	ぶ
be	べ
bo	ぼ
m	ま
ma	ま
mi	み
mu	む
me	め
mo	も
w	わ
wa	わ
wi	ゐ
we	ゑ
wo	を
v	ゔ
va	ゔぁ
vi	ゔぃ
vu	ゔ
ve	ゔぇ
vo	ゔぉ
z	ざ
za	ざ
zu	ず
ze	ぜ
zo	ぞ
l		ん
_ー
€	？
'	っ
"	.
{	『
}	』
