;	。
,	か
.	た
p	こ
y	さ
f	ら
g	ち
c	く
r	つ
a	う
o	し
e	て
u	け
i	せ
d	は
h	と
t	き
n	い
s	ん
q	ひ
j	す
k	ふ
x	へ
b	め
m	そ
w	ね
v	ほ
z	・
:	ぁ
!	え
?	り
P	ゃ
Y	れ
F	よ
G	に
C	る
R	ま
L	ぇ
A	を
O	あ
E	な
U	ゅ
I	も
D	み
H	お
T	の
N	ょ
S	っ
Q	ー
J	ろ
K	や
X	ぃ
B	ぬ
M	ゆ
W	む
V	わ
Z	ぉ
l,	が
l.	だ
lp	ご
ly	ざ
lf	ぱ
lg	ぢ
lc	ぐ
lr	づ
la	ゔ
lo	じ
le	で
lu	げ
li	ぜ
ld	ば
lh	ど
lt	ぎ
ln	ぽ
ls	ん
lq	び
lj	ず
lk	ぶ
lx	べ
lb	ぷ
lm	ぞ
lw	ぺ
lv	ぼ
ll	ぴ
/	、
€	？
'	ぅ
"	.
{	『
}	』
