.	。
,	、
:	：
!	！
?	？
_	ー
-	ー
{	『
}	』

A	ぁ
I	ぃ
U	ぅ
E	ぇ
O	ぉ
wA	ゎ
cA	ヵ
cE	ヶ

a	あ
o	お
e	え
u	う
i	い
p	ぱ
pa	ぱ
pi	ぴ
pya	ぴゃ
pyi	ぴぃ
pyu	ぴゅ
pye	ぴぇ
pyo	ぴょ
pu	ぷ
pwa	ぷぁ
pwi	ぷぃ
pwu	ぷぅ
pwe	ぷぇ
pwo	ぷぉ
pe	ぺ
po	ぽ
y	や
ya	や
yu	ゆ
yo	よ
f	ふ
fa	ふぁ
fi	ふぃ
fu	ふ
fe	ふぇ
fo	ふぉ
g	が
ga	が
gi	ぎ
gya	ぎゃ
gyi	ぎぃ
gyu	ぎゅ
gye	ぎぇ
gyo	ぎょ
gu	ぐ
gwa	ぐぁ
gwi	ぐぃ
gwu	ぐぅ
gwe	ぐぇ
gwo	ぐぉ
ge	げ
go	ご
ts	つ
tsa	つぁ
tsi	つぃ
tsu	つ
tse	つぇ
tso	つぉ
r	ら
ra	ら
ri	り
rya	りゃ
ryi	りぃ
ryu	りゅ
rye	りぇ
ryo	りょ
ru	る
rwa	るぁ
rwi	るぃ
rwu	るぅ
rwe	るぇ
rwo	るぉ
re	れ
ro	ろ
d	だ
da	だ
di	でぃ
de	で
do	ど
dj
dja
dji
dju
dje
djo
dz	づ
dza	づぁ
dzi	づぃ
dzu	づ
dze	づぇ
dzo	づぉ
h	は
ha	は
hi	ひ
he	へ
ho	ほ
t	た
ta	た
ti  てぃ
tu	とぅ
te	て
to	と
n'	ん
n	ん
na	な
ni	に
nya	にゃ
nyi	にぃ
nyu	にゅ
nye	にぇ
nyo	にょ
nu	ぬ
nwa	ぬぁ
nwi	ぬぃ
nwu	ぬぅ
nwe	ぬぇ
nwo	ぬぉ
ne	ね
no	の
s	さ
sa	さ
su	す
swa	すぁ
swi	すぃ
swu	すぅ
swe	すぇ
swo	すぉ
se	せ
so	そ
k	ち
ka	ちゃ
ki	ち
ku	ちゅ
ke	ちぇ
ko	ちょ
j	じ
ja	じゃ
ji	じ
ju	じゅ
je	じぇ
jo	じぉ
c	か
ca	か
ci	き
cya	きゃ
cyi	きぃ
cyu	きゅ
cye	きぇ
cyo	きょ
cu	く
cwa	くぁ
cwi	くぃ
cwu	くぅ
cwe	くぇ
cwo	くぉ
ce	け
co	こ
x	し
xa	しゃ
xi	し
xu	しゅ
xe	しぇ
xo	しょ
b	ば
ba	ば
bi	び
bya	びゃ
byi	びぃ
byu	びゅ
bye	びぇ
byo	びょ
bu	ぶ
bwa	ぶぁ
bwi	ぶぃ
bwu	ぶぅ
bwe	ぶぇ
bwo	ぶぉ
be	べ
bo	ぼ
m	ま
ma	ま
mi	み
mya	みゃ
myi	みぃ
myu	みゅ
mye	みぇ
myo	みょ
mu	む
mwa	むぁ
mwi	むぃ
mwu	むぅ
mwe	むぇ
mwo	むぉ
me	め
mo	も
w	わ
wa	わ
wi	うぃ
wu	うぅ
we	うぇ
wo	を
v	ゔ
va	ゔぁ
vi	ゔぃ
vu	ゔ
ve	ゔぇ
vo	ゔぉ
z	ざ
za	ざ
zu	ず
zwa	ずぁ
zwi	ずぃ
zwu	ずぅ
zwe	ずぇ
zwo	ずぉ
ze	ぜ
zo	ぞ
l	ん
'	っ
